10
10
WWWWWWWWWW
W        W
W        W
W        W
W   d    W
W        W
W   u    W
W        W
W        W
WWWWWWWWWW