{
  "SizeY": 50,
  "SizeX": 50,
  "Data": [
"WWWWWWWWWWWWWWWWWWWWWWWWWWWWWWWWWWWWWWWWWWWWWWWWWW"
"WWWWWWWWWWWWWWWWWWWWWWWWWWWWWWWWWWWWWWWWWWWWWWWWWW"
"WWWWW     WWWWWWWWWWWWWWWWWWWWWWWWWWWWWWWWWWWWWWWW"
"WWWWW     WWWWWWWWWWWWWWWWWWWWWWWWWWWWWWWWWWWWWWWW"
"WWWWW     WWWWWWWWWWWWWWWWWWWWWWWWWWWWWWWWWWWWWWWW"
"WWWWW                     WWWWWWWWWWWWWWW     WWWW"
"WWWWW     WWWWWWWWWWWW    WWWWWWWWWWWWWWW     WWWW"
"WWWWWWWWWWWWWWWWWWWWWW                        WWWW"
"WWWWWWWWWWWWWWWWWWWWWW    WWWWW WWWWWWWWW     WWWW"
"WWWWWWWWWWWWWWWWWWWWWWWW WWWWWW WWWWWWWWW     WWWW"
"WWWWWWWWWWWWWWWWWWWWWWWW WWWWWW WWWWWWWWWWWWWWWWWW"
"WWWWWWWWWWWWWWWWWWWWWW    WWWWW WWWWWWWWWWWWWWWWWW"
"WWWWWWWWWWWWWWWWWWWWWW    WWWW   WWWWWWWWWWWWWWWWW"
"WWWWWWWWWWWWWWWWWWWWWW    WWWW   WWWWWWWWWWWWWWWWW"
"WWWWWWWWWWWWWWWWWWWWWW           WWWWWWWWWWWWWWWWW"
"WWWWWWWWWWWWWWWWWWWWWWWW WWWWWWW WWWWWWWWWWWWWWWWW"
"WWWWWWWWWWWWWWWWWWWWWWWW WWWWWWW WWWWWWWWWWWWWWWWW"
"WWWWWWWWWWWWWWWWWWWWWWWW WWWWWWW WWWWWWWWWWWWWWWWW"
"WWWWWWWWWWWWWWWWWWWWWWWW WWWWWWW WWWWWWW   WWWWWWW"
"WWWWWWWWWWWWWWWWWWWWWWWW WWWWWWW           WWWWWWW"
"WWWWWWWWWWWWWWWWWWWWWWWW WWWWWWWWWWWWWWW   WWWWWWW"
"WWWWWWWWWWWWWWWWWWWWWWWW WWWWWWWWWWWWWWW   WWWWWWW"
"WWWWWWWWWWWWWWWWWWW         WWWWWWWWWWWW   WWWWWWW"
"WWWWWWWWWWWWWWWWWWW         WWWWWWWWWWWW   WWWWWWW"
"WWWWWWWWWWWWWWWWWWW         WWWWWWWWWWWW   WWWWWWW"
"WWWWWWWWWWWWWWWWWWWW WWWWW WWWWWWWWWWWWWWWWWWWWWWW"
"WWWWWW     WWWWWWWWW WWWWW WWWWWWWWWWWWWWWWWWWWWWW"
"WWWWWW     WWWWWWWWW WWWWW WWWWWWWWWWWWWWWWWWWWWWW"
"WWWWWW               WWWWW       WWWWWWWWWWWWWWWWW"
"WWWWWW     WWWWWWW WWWWWWW       WWWWWWWWWWWWWWWWW"
"WWWWWW     WWWWWWW WWWWWWW          WWWWWWWWWWWWWW"
"WWWWWWWWWWWWWWWWWW WWWWWWWWWWWWWWWW WWWWWWWWWWWWWW"
"WWWWWWWWWWWWWWWWWW WWWWWWWWWWWWWWWW    WWWWWWWWWWW"
"WWWWWWWWWWWWWW        WWWWWWWWWWWWW  W  WWWWWWWWWW"
"WWWWWWWWWWWWWW        WWWWWWWWWWWWWWWWWWWWWWWWWWWW"
"WWWWWWWWWWWWWW        WWWWWWWWWWWWWWWWWWWWWWWWWWWW"
"WWWWWWWWWWWWWWWWWW WWWWWWWWWWWWWWW         WWWWWWW"
"WWWWWWWWWWWWWWWWWW WWWWWWWWWWWWWWW          WWWWWW"
"WWWWWWWWWWWWWWWWWW WWWWWWWWWWWWWWW        WWWWWWWW"
"WWWWWWW                                     WWWWWW"
"WWWWWWW WWWWWWWWWW WWWWWWWWWWWWWWW           WWWWW"
"WWWWWWW WWWWWWWWWW WWWWWWWWWWWWWWW          WWWWWW"
"WWWWWWW WWWWWWWWWW WWWWWWWWWWWWWWW          WWWWWW"
"WWWW    WWWWW          WWWWWWWWWWW          WWWWWW"
"WWWW    WWWWW          WWWWWWWWWWW           WWWWW"
"WWWW    WWWWW          WWWWWWWWWWWWWWWWWWWWWWWWWWW"
"WWWWWWWWWWWWW          WWWWWWWWWWWWWWWWWWWWWWWWWWW"
"WWWWWWWWWWWWWWWWWWWWWWWWWWWWWWWWWWWWWWWWWWWWWWWWWW"
"WWWWWWWWWWWWWWWWWWWWWWWWWWWWWWWWWWWWWWWWWWWWWWWWWW"
"WWWWWWWWWWWWWWWWWWWWWWWWWWWWWWWWWWWWWWWWWWWWWWWWWW"
  ],
  "EnemyType": [
    {
      "Type": 0,
      "Class": 0
    }
  ],
  "AddFeatures": true
}