{
  "SizeY": 15,
  "SizeX": 15,
  "Data": [
"WWWWWWWWWWWWWWW"
"W             W"
"W             W"
"W             W"
"W    WWWWW    W"
"W    W   W    W"
"W    W   W    W"
"W        W    W"
"W    W   W    W"
"W    W   W    W"
"W    WWWWW    W"
"W             W"
"W             W"
"W             W"
"WWWWWWWWWWWWWWW"
  ],
  "EnemyType": [
    {
      "Type": 0,
      "Class": 0
    }
  ],
  "AddFeatures": true
}