10
11
WWWWWWWWWW
W        W
WWWWWWWW W
W        W
W WWWWWWWW
W        W
WWWWWWWW W
W        W
W WWWWWWWW
W        W
WWWWWWWWWW
Tag:Dungeon
Next:Dungeon
Enemy:Imp
Enemy:Imp