15
15
WWWWWWWWWWWWWWW
W             W
W             W
W             W
W    WWWWW    W
W    W   W    W
W    W   W    W
W        W    W
W    W   W    W
W    W   W    W
W    WWWWW    W
W             W
W             W
W             W
WWWWWWWWWWWWWWW
Tag:Dungeon
Next:Dungeon
Enemy:Imp
Enemy:Imp
Enemy:Imp
Enemy:Imp