{
  "Size": {
    "Width": 10,
    "Height": 11,
  },
  "Data": [
    "WWWWWWWWWW",
    "W        W",
    "W WWWWWWWW",
    "W        W",
    "WWWWWWWW W",
    "W        W",
    "W WWWWWWWW",
    "W        W",
    "WWWWWWWWWW",
  ],
  "EnemyType": [
    {
      "Type": 0,
      "Class": 0
    }
  ]
}